NO ./textures/north.xpm
SO ./textures/south.xpm
WE ./textures/west.xpm
EA ./textures/east.xpm

F 220, 100, 0
C 225,30,0

1111111111111111111111111
1000000000110000000000001
101100000111000000000000100000000
100100000000000000000000111111111
111111111013000001110000000000001
100000000012000001110111160111111
11110111111211011100000010001
11110111111111011101010040001
11000000110101011100000040001
10000000000000001100000040001
10000000000000001101010040N01
1100000111010101111101111000111
11110111 1110101 101111010001
11111111 1011111 111111111111